{
  "grid" : [
    [1, 0, 0, 3, 0, 0, 2, 0, 2, 1],
    [0, 0, 0, 0, 0, 0, 4, 2, 1, 1],
    [0, 3, 1, 1, 0, 3, 0, 0, 0, 2],
    [0, 0, 1, 1, 0, 0, 0, 0, 0, 2],
    [0, 0, 0, 1, 0, 0, 0, 3 ,4 ,0],
    [0, 3, 0, 4, 4, 3, 0, 0 ,0, 1]
  ],
  "playerBase": {
    "asset": "house",
    "row": 1,
    "col": 3
  },
  "enemyBase": {
    "asset": "darkTemple",
    "row": 3,
    "col": 8
  }
}